NAME : test100-dir
COMMENT : More fun with graphs!
GRAPH : DIRECTED
DIMENSION : 100
EDGE_DIRECTIONS_SECTION
3 4 5 6 8 9 10 11 13 15
1 4 5 7 8 9 10 11 12 13
1 7 8 9 14 17
6 11 12
3 4 8 12
1 5 7 9 10 12 13 14 18 20
1 4 6 9 10 19 20
3 15 18 22
1 2 3 4 6 8 12 16 21
4 6 7 9 15 20 24
2 4 5 12 21 24
1 4 6 7 10 13 16 17 23 24
3 7 22
3 4 5 9 10 17
3 4 9 10 16 17 24 29
3 5 11 14 17 18 19 26 28 30
10 11 12 24 27
10 28 31
5 7 9 15 16 23 24
6 10 13 17 25 26 27 28 33
8 12 14 30 34
7 8 26 29 35
18 21 29 33
10 11 18 21 28
13 16 21 23 27 39
11 18 31 39
15 19 21 37
17 20 21 26 35
14 15 16 19 21 28 31 35 36 43
15 18 19 24 28 29 31 33 34 42
19 29 43
21 23 24 26 27 28 29 31 38 42
21 22 23 24 26 31 41 45
20 40 42 43 48
25 30 32 33 34 39 41
30 32 39
30 45 47 48 51
37 39 40
25 26 30 40
30 32 34 41 47 48 50 51
31 33 40 46 47 48 50 52
27 39 44 49 50
29 31 34 41 42 45 47 51
29 30 43 45 46 50 52
33 34 43 47 54 58
31 33 41 43 45 47 49 58 59
37 38 49 59 61
35 42 60
36 57 63
36 43 44 46 47 51 52 56 57 64
44 46 52 56
38 39 41 42 44 48 55 56
41 47 51 52 59 64 65 67
41 43 51 52 58 64 65 68
45 61 66
42 47 48 50 54 58 59 61 62 69
42 47 56 60 62 68
46 49 53 54 59 69
45 49 52 54 56 58 69
45 51 52 56 57 58 61 65 69
47 50 59 60 62 64 71 73 75
54 58 61 69 70
50 55 64 70 71 72 74 77
67 71 73
56 62 64 68 70 77 78
52 61 65 72 75
54 59 63 64 66 70 73 75 81
63 72 82
56 58 59 61 62 72 73 79 82
57 62 66 71 72
61 62 63 64 67 69 70 74 77 78
59 63 70 73 74 76 78 83
58 62 69 70 71 72 78 79 80 85
60 62 64 68 69 71 75 77 79 85
64 67 72 82
71 72 85 86
62 68 84
67 69 73 75 82 83 84 85 86 87
74 78 80 85 87 88 90 91
67 70 71 85 91
66 77 79 86 95
69 71 80 86 92
68 81 88 91 93 94 96
79 87 97 98
70 74 82 86 91 93
72 77 79 81 84 85 87 88 91 99
75 78 79 85 92
73 83 90 98 99
77 82 86 87
76 77 82 87 89 92 99 100
76 78 84 85 86 89 92 96
78 79 82 83 87 88 89 93 98 100
78 80 81 88 91 98
80 84 90 91 93 95 97 99
80 81 83 84 85 91 92 100
84 85 88 89 93 99
89 90 99
84 86 88 90 91 93 95 96 97 100
85 86 88 89 92 93 94 95 98 100
88 94 95 97
EDGE_WEIGHT_SECTION
20 43 26 28 45 49 27 30 40 46
46 32 25 33 26 39 33 23 46 42
14 22 35 46 13 12
47 46 34
35 44 32 37
25 11 18 30 41 11 39 30 34 10
47 50 43 29 50 16 49
16 50 21 47
16 28 27 10 17 25 36 36 29
15 10 39 29 28 27 20
38 23 31 44 26 34
49 42 34 47 32 43 31 41 20 49
20 46 28
20 31 14 19 40 20
35 32 20 34 35 20 28 41
29 48 20 46 34 49 41 40 21 34
33 34 32 46 16
14 45 27
30 41 40 18 33 28 14
14 35 49 24 23 39 22 25 33
47 25 16 15 16
48 20 25 29 38
10 35 36 46
37 28 23 40 43
25 44 29 22 35 45
38 27 49 43
29 16 45 34
13 50 18 27 35
32 13 36 35 13 46 49 33 26 35
36 43 31 45 46 33 44 40 37 23
23 20 14
50 17 43 15 15 20 44 43 18 17
33 28 23 28 23 24 13 15
31 12 35 11 48
30 25 50 45 48 37 27
34 28 24
41 19 26 48 29
42 13 44
37 23 47 44
19 23 20 43 42 28 10 34
46 45 29 40 46 22 14 47
11 21 50 40 28
12 30 46 34 35 17 37 11
46 22 47 14 36 22 26
49 33 23 45 32 21
27 50 16 32 42 28 14 45 27
28 47 24 20 27
43 31 27
12 36 20
49 28 28 24 10 21 10 33 25 42
38 48 30 18
21 40 10 23 33 36 35 24
19 29 19 24 46 49 47 47
40 48 20 18 45 26 20 38
37 37 39
36 13 48 10 23 21 49 33 10 16
12 38 28 50 13 30
30 27 43 41 41 15
18 17 22 49 34 42 17
38 43 43 11 34 18 11 33 24
44 32 49 33 46 42 13 19 41
46 43 12 49 38
23 13 49 39 32 27 40 13
49 21 43
29 20 45 31 49 27 49
41 33 16 44 49
46 44 50 19 24 39 13 47 29
16 38 29
40 25 25 45 47 10 32 26 33
33 14 36 25 16
24 45 44 30 46 28 25 36 47 24
32 42 11 50 12 25 13 50
10 15 47 48 45 24 48 21 34 28
44 22 21 13 30 34 23 31 30 13
34 31 45 20
44 25 25 13
24 31 28
27 50 18 49 24 18 19 25 18 24
21 19 34 46 42 10 13 30
19 33 18 28 16
50 40 32 24 40
23 48 29 31 12
35 14 41 14 45 23 24
11 49 36 18
11 25 14 22 23 38
29 45 18 44 22 20 34 32 31 36
23 13 12 14 22
17 14 31 19 39
44 42 29 24
15 13 41 47 18 15 17 29
25 33 45 34 24 25 32 44
12 38 33 18 22 25 14 33 46 43
17 18 18 37 31 34
38 14 50 20 42 29 35 46
23 25 28 11 41 16 24 35
49 50 50 45 22 30
37 37 38
29 10 22 17 10 46 23 24 31 24
11 50 29 43 46 13 34 15 43 25
31 45 40 49
